basisphenoid_ant	neurocranium
basisphenoid_post	neurocranium
bo_ant	neurocranium
cranium_occipital	neurocranium
cranium_sagittal	neurocranium
foramen_magnum_sup	neurocranium
ju_qd_L	quadrate_L
ju_qd_R	quadrate_R
ju_ub_L	upperbeak
ju_ub_R	upperbeak
mc_qd_l_L	quadrate_L
mc_qd_l_R	quadrate_R
mc_qd_m_L	quadrate_L
mc_qd_m_R	quadrate_R
nc_qd_l_L	neurocranium
nc_qd_l_R	neurocranium
nc_qd_m_L	neurocranium
nc_qd_m_R	neurocranium
nc_ub_L	upperbeak
nc_ub_R	upperbeak
oc_cd	neurocranium
op_dist_L	quadrate_L
op_dist_R	quadrate_R
op_inf_L	quadrate_L
op_inf_R	quadrate_R
op_sup_L	quadrate_L
op_sup_R	quadrate_R
opisthotic_process_L	neurocranium
opisthotic_process_R	neurocranium
pa_lc_a_L	palatine_L
pa_lc_a_R	palatine_R
pa_lc_p_L	palatine_L
pa_lc_p_R	palatine_R
pa_mc_a_L	palatine_L
pa_mc_a_R	palatine_R
pa_mc_p_L	palatine_L
pa_mc_p_R	palatine_R
pa_pt_L	pterygoid_L
pa_pt_R	pterygoid_R
pa_ub_L	upperbeak
pa_ub_R	upperbeak
palatine_lat_crest_L	palatine_L
palatine_lat_crest_R	palatine_R
palatine_med_crest_L	palatine_L
palatine_med_crest_R	palatine_R
postorbital_process_distal_sup_L	neurocranium
postorbital_process_distal_sup_R	neurocranium
preorbital_process_distal_L	neurocranium
preorbital_process_distal_R	neurocranium
pslider_palatine_L	palatine_L
pslider_palatine_R	palatine_R
pslider_pterygoid_L	pterygoid_L
pslider_pterygoid_R	pterygoid_R
pt_ac_a_L	pterygoid_L
pt_ac_a_R	pterygoid_R
pt_ac_p_L	pterygoid_L
pt_ac_p_R	pterygoid_R
pt_qd_L	quadrate_L
pt_qd_R	quadrate_R
ub_tip	upperbeak
upper_bill_culmen	upperbeak
upper_bill_tomium_L	upperbeak
upper_bill_tomium_R	upperbeak
upperbeak_tomium_prox_L	upperbeak
upperbeak_tomium_prox_R	upperbeak
upperbill_cranium	neurocranium