basicranium_ant	neurocranium
basicranium_centrum	neurocranium
nc_ep	neurocranium
cranium_sagittal_mid	neurocranium
cranium_sagittal_pos	neurocranium
nc_vc	neurocranium
foramen_magnum	neurocranium
hyomand_process_ant_L	suspensorium_L
hyomand_process_ant_R	suspensorium_R
hyoman_ant_proc_L	suspensorium_L
hyoman_ant_proc_R	suspensorium_R
hypohyal_midline_ant	hypohyal
hypohyal_midline_pos	hypohyal
lj_qd_L	lowerjaw_L
lj_qd_R	lowerjaw_R
operc_series_sup_pos_L	neurocranium
operc_series_sup_pos_R	neurocranium
px_mid	neurocranium
urohyal_ant_proc	hypohyal
hy_sh_L	hypohyal
hy_sh_R	hypohyal
lj_sy_sup	lowerjaw_L
lj_sy_inf	lowerjaw_L
ljaw_art_proc_L	lowerjaw_L
ljaw_art_proc_R	lowerjaw_R
nc_su_a_L	suspensorium_L
hyoman_cranium_pos_L	suspensorium_L
su_pt_L	suspensorium_L
hyoman_ljaw_L	suspensorium_L
operc_pos_sup_L	suspensorium_L
operc_pos_inf_L	suspensorium_L
nc_su_a_R	suspensorium_R
hyoman_cranium_pos_R	suspensorium_R
su_pt_R	suspensorium_R
hyoman_ljaw_R	suspensorium_R
operc_pos_sup_R	suspensorium_R
operc_pos_inf_R	suspensorium_R
ac_as	hypohyal
hy_mid	hypohyal
hy_mid	hyoid_L
ac_hy_L	hyoid_L
ac_hy_R	hyoid_R
cerhyal_ant_L	hyoid_L
cerhyal_inf_L	hyoid_L
cerhyal_pos_L	hyoid_L
cerhyal_sup_L	hyoid_L
cerhyal_ant_R	hyoid_R
cerhyal_inf_R	hyoid_R
cerhyal_pos_R	hyoid_R
cerhyal_sup_R	hyoid_R
ac_as_L	hyoid_L
ac_hy_L	hyoid_L
ac_pi_L	hyoid_L
ac_ps_L	hyoid_L
pc_as_L	hyoid_L
pc_su_L	hyoid_L
pc_ai_L	hyoid_L
ac_as_R	hyoid_R
ac_hy_R	hyoid_R
ac_pi_R	hyoid_R
ac_ps_R	hyoid_R
pc_as_R	hyoid_R
pc_su_R	hyoid_R
pc_ai_R	hyoid_R
hypohyal_ant_L	hypohyal
hypohyal_pos_L	hypohyal
hypohyal_ant_R	hypohyal
hypohyal_pos_R	hypohyal
urohyal_sup_pos	hypohyal
urohyal_ant_proc	hypohyal
urohyal_inf_pos	hypohyal
orb_ridge_ant_L	neurocranium
orb_ridge_pos_L	neurocranium
orb_ridge_ant_R	neurocranium
orb_ridge_pos_R	neurocranium
premax_midline_pos	neurocranium
px_ip_L	neurocranium
px_ip_R	neurocranium
cranium_sup_pos	neurocranium

ljaw_symph	lowerjaw_L
cranium_sup	neurocranium
cranium_pos	neurocranium
premax_midline	neurocranium
urohyal_midline_sup	hypohyal
urohyal_midline_inf	hypohyal

operc_pos_L	suspensorium_L
hyoman_pos_L	suspensorium_L
hyoman_inf_L	suspensorium_L
hyoman_sup_L	suspensorium_L
hyoman_ant_L	suspensorium_L
hyoman_joint_L	suspensorium_L
epihyal_ant_L	hyoid_L
epihyal_inf_L	hyoid_L
epihyal_pos_L	hyoid_L
ljaw_sup_L	lowerjaw_L
ljaw_inf_L	lowerjaw_L
hypohyal_sup_L	hypohyal
hypohyal_inf_L	hypohyal
premax_orb_L	neurocranium
premax_inf_L	neurocranium
premax_pos_L	neurocranium
orb_ridge_L	neurocranium

operc_pos_R	suspensorium_R
hyoman_pos_R	suspensorium_R
hyoman_inf_R	suspensorium_R
hyoman_sup_R	suspensorium_R
hyoman_ant_R	suspensorium_R
hyoman_joint_R	suspensorium_R
epihyal_ant_R	hyoid_R
epihyal_inf_R	hyoid_R
epihyal_pos_R	hyoid_R
ljaw_sup_R	lowerjaw_R
ljaw_inf_R	lowerjaw_R
hypohyal_sup_R	hypohyal
hypohyal_inf_R	hypohyal
premax_orb_R	neurocranium
premax_inf_R	neurocranium
premax_pos_R	neurocranium
orb_ridge_R	neurocranium
